NO ./bonus/assets/walls/stone_bricks/wall_n.xpm
SO ./bonus/assets/walls/stone_bricks/wall_s.xpm
WE ./bonus/assets/walls/stone_bricks/wall_w.xpm
EA ./bonus/assets/walls/stone_bricks/wall_e.xpm

F 34,139,34 
C 135,206,235

11111111111111111111111
1000000D000000000000001
10000011111011101111101
10000K1   1010000011101
1000001   1010111010101
10N0001   1010000010101
1111101   1011011110101
1000001   1000000000D01
1011111   1111111111101
10001               101
11011         11111110111111
 1D1          100000000000011111
 10111111111  100000000000010001111111
 10000000001  10101010101011110100C001
 11111000001  101010101010100D01000001
     1000001  1D1011D10100011111D1111
     1000001111011101111111111110001
     1000000D00000000000000000D00111
     111111111111111111000111111111
        110001   111111100000000001
        1D0001   100000000111111011
        1100011  10111111110F000011
         100001  100000111111111111
         101111  1111101
         1D1         101
         101111111111101
         1000000D0000001
         111111111111111