NO ./bonus/assets/walls/stone_bricks/wall_n.xpm
SO ./bonus/assets/walls/stone_bricks/wall_s.xpm
WE ./bonus/assets/walls/stone_bricks/wall_w.xpm
EA ./bonus/assets/walls/stone_bricks/wall_e.xpm

F 34,139,34 
C 135,206,235

11111111111111111111111
1P00000D000000000000001
100000111110111D1111101
10000K1   1010000011101
10000T1   1010111010101
1BN0001   1010000010101
1111101   1011011110101
1000001   1000000000D01
1011111   1111111111101
10001               101
11011         11111110111111
 1D1          1T0000000000011111
 10111111111  100000000000010001111111
 10000000001  10101010101011110100C001
 11111000001  101010100101010001000001
     1000001  101011D10100011111D1111
     1000001111011100111111111110001
     1000000D00000000000000000D00111
     111111111111111111000111111111
       11110001   111111100000000001
       10X00001  1000000000111111011
       11100011  1011111111IF000001
         100001  100000111111111111
         101111  1111101
         1D1         101
         101111111111101
         1000000D0000001
         111111111111111