NO ./bonus/assets/walls/stone_bricks/wall_n.xpm
SO ./bonus/assets/walls/stone_bricks/wall_s.xpm
WE ./bonus/assets/walls/stone_bricks/wall_w.xpm
EA ./bonus/assets/walls/stone_bricks/wall_e.xpm

F 34,139,34 
C 135,206,235

        1111111111111111111111111
        1000000000110000000000001
        1011000001110000000000001
        1001000000000000000000001
111111111011000001110000000000001
100000000011000001110111111111111
1111F1111111110111000000100K001
1111F11111111101110101001000001
110000001101010111000000100K001
1000000000000000110000001000001
1000000000000000110101001000001
11000001110101011111000000N0001
11110111 1110101 10111101000111
11111111 1111111 111111111111