NO ./bonus/assets/walls/stone_bricks/wall_n.xpm
SO ./bonus/assets/walls/stone_bricks/wall_s.xpm
WE ./bonus/assets/walls/stone_bricks/wall_w.xpm
EA ./bonus/assets/walls/stone_bricks/wall_e.xpm

F 34,139,34 
C 135,206,235

        1111111111111111111111111
        1000000000110000000000F01
        1011000001110000000000001
        10010000000D0000000000001
111111111011000001110000000000001
1000000000110000011101111111D1111
1111011111111101110000001000001
1111111111111100D0000100100001
10000000110101D111000000D00K001
100000001000000011D111111000001
10000000D0000000D00000000000001
11000001110101011111000C00N0001
11110111 1110101 10111101000111
11111111 1111111 111111111111