NO ./bonus/assets/walls/stone_bricks/wall_n.xpm
SO ./bonus/assets/walls/stone_bricks/wall_s.xpm
WE ./bonus/assets/walls/stone_bricks/wall_w.xpm
EA ./bonus/assets/walls/stone_bricks/wall_e.xpm

F 34,139,34 
C 135,206,235

1111111111111111111111
1000000000000000000001
1000000000000000000001
1000000000F00000000001
1000000000000000000001
1000000000000000000001
1000000000000000000001
1000000000N00000000001
1111111111111111111111